S No.,Value Date,Transaction Date,Withdrawal Amount(INR),Deposit Amount(INR),Balance(INR),
1,"17,10,2024","17,10,2024",774.63,0.00,17216.40,
2,"17,10,2024","17,10,2024",281.03,0.00,16935.37,
3,"17,10,2024","17,10,2024",0.00,774.63,17710.00,
4,"17,10,2024","17,10,2024",692.02,0.00,17017.98,
5,"17,10,2024","17,10,2024",131.00,0.00,16886.98,
6,"17,10,2024","17,10,2024",238.00,0.00,16648.98,
7,"17,10,2024","17,10,2024",27.00,0.00,16621.98,
8,"17,10,2024","17,10,2024",36.00,0.00,16585.98,
9,"17,10,2024","17,10,2024",33.00,0.00,16552.98,
10,"18,10,2024","18,10,2024",112.00,0.00,16440.98,
11,"18,10,2024","18,10,2024",119.00,0.00,16321.98,
12,"18,10,2024","18,10,2024",50.00,0.00,16271.98,
13,"18,10,2024","18,10,2024",34.00,0.00,16237.98,
14,"18,10,2024","18,10,2024",27.00,0.00,16210.98,
15,"18,10,2024","18,10,2024",110.00,0.00,16100.98,
16,"19,10,2024","19,10,2024",111.00,0.00,15989.98,
,,,,,,
17,"19,10,2024","19,10,2024",119.00,0.00,15870.98,
18,"19,10,2024","19,10,2024",36.00,0.00,15834.98,
19,"19,10,2024","19,10,2024",27.00,0.00,15807.98,
20,"19,10,2024","19,10,2024",13443.35,0.00,2364.63,
21,"21,10,2024","21,10,2024",169.00,0.00,2195.63,
22,"21,10,2024","21,10,2024",119.00,0.00,2076.63,
23,"21,10,2024","21,10,2024",27.00,0.00,2049.63,
24,"22,10,2024","22,10,2024",119.00,0.00,1930.63,
25,"22,10,2024","22,10,2024",27.00,0.00,1903.63,
26,"23,10,2024","23,10,2024",119.00,0.00,1784.63,
27,"23,10,2024","23,10,2024",24.00,0.00,1760.63,
28,"23,10,2024","23,10,2024",27.00,0.00,1733.63,
29,"23,10,2024","23,10,2024",27.00,0.00,1706.63,
30,"23,10,2024","23,10,2024",0.00,27.00,1733.63,
31,"23,10,2024","23,10,2024",0.00,27.00,1760.63,
32,"24,10,2024","24,10,2024",119.00,0.00,1641.63,
33,"24,10,2024","24,10,2024",50.00,0.00,1591.63,
34,"24,10,2024","24,10,2024",36.00,0.00,1555.63,
35,"28,10,2024","28,10,2024",119.00,0.00,1436.63,
36,"28,10,2024","28,10,2024",27.00,0.00,1409.63,
37,"28,10,2024","28,10,2024",15.00,0.00,1394.63,
38,"29,10,2024","29,10,2024",119.00,0.00,1275.63,
39,"29,10,2024","29,10,2024",50.00,0.00,1225.63,
40,"29,10,2024","29,10,2024",40.00,0.00,1185.63,
41,"29,10,2024","29,10,2024",0.00,80666.00,81851.63,
42,"30,10,2024","30,10,2024",255.83,0.00,81595.80,
43,"30,10,2024","30,10,2024",3370.92,0.00,78224.88,
44,"30,10,2024","30,10,2024",119.00,0.00,78105.88,
45,"30,10,2024","30,10,2024",50.00,0.00,78055.88,
46,"30,10,2024","30,10,2024",40.00,0.00,78015.88,
47,"01,11,2024","01,11,2024",1000.00,0.00,77015.88,
48,"01,11,2024","01,11,2024",9000.00,0.00,68015.88,
49,"01,11,2024","01,11,2024",458.81,0.00,67557.07,
50,"02,11,2024","02,11,2024",129.00,0.00,67428.07,
51,"02,11,2024","02,11,2024",119.00,0.00,67309.07,
52,"03,11,2024","03,11,2024",19476.00,0.00,47833.07,
53,"03,11,2024","03,11,2024",0.00,19476.00,67309.07,
54,"03,11,2024","03,11,2024",60.00,0.00,67249.07,
55,"03,11,2024","03,11,2024",70.00,0.00,67179.07,
56,"03,11,2024","03,11,2024",18000.00,0.00,49179.07,
57,"03,11,2024","03,11,2024",24114.00,0.00,25065.07,
58,"03,11,2024","03,11,2024",0.00,24114.00,49179.07,
59,"05,11,2024","05,11,2024",100.00,0.00,49079.07,
60,"06,11,2024","06,11,2024",152.00,0.00,48927.07,
61,"06,11,2024","06,11,2024",125.00,0.00,48802.07,
62,"06,11,2024","06,11,2024",27.00,0.00,48775.07,
63,"06,11,2024","06,11,2024",500.00,0.00,48275.07,
64,"06,11,2024","06,11,2024",50.00,0.00,48225.07,
65,"07,11,2024","07,11,2024",468.81,0.00,47756.26,
66,"08,11,2024","08,11,2024",125.00,0.00,47631.26,
67,"08,11,2024","08,11,2024",599.00,0.00,47032.26,
68,"10,11,2024","10,11,2024",0.00,211129.00,258161.26,
69,"10,11,2024","10,11,2024",311.00,0.00,257850.26,
70,"10,11,2024","10,11,2024",500.00,0.00,257350.26,
71,"10,11,2024","10,11,2024",5000.00,0.00,252350.26,
72,"11,11,2024","11,11,2024",0.00,10000.00,262350.26,
73,"11,11,2024","11,11,2024",35.00,0.00,262315.26,
74,"11,11,2024","11,11,2024",35.00,0.00,262280.26,
75,"11,11,2024","11,11,2024",119.00,0.00,262161.26,
76,"12,11,2024","12,11,2024",90.00,0.00,262071.26,
77,"12,11,2024","12,11,2024",50.00,0.00,262021.26,
78,"12,11,2024","12,11,2024",35.00,0.00,261986.26,
79,"13,11,2024","13,11,2024",100000.00,0.00,161986.26,
80,"13,11,2024","13,11,2024",119.00,0.00,161867.26,
81,"13,11,2024","13,11,2024",13413.51,0.00,148453.75,
82,"13,11,2024","13,11,2024",35.00,0.00,148418.75,
83,"14,11,2024","14,11,2024",100000.00,0.00,48418.75,
84,"14,11,2024","14,11,2024",119.00,0.00,48299.75,
85,"14,11,2024","14,11,2024",15.00,0.00,48284.75,
86,"14,11,2024","14,11,2024",50.00,0.00,48234.75,
87,"14,11,2024","14,11,2024",262.82,0.00,47971.93,
88,"15,11,2024","15,11,2024",1000.00,0.00,46971.93,
89,"16,11,2024","16,11,2024",119.00,0.00,46852.93,
90,"17,11,2024","17,11,2024",6000.00,0.00,40852.93,
91,"17,11,2024","17,11,2024",1000.00,0.00,39852.93,
92,"17,11,2024","17,11,2024",500.00,0.00,39352.93,
93,"17,11,2024","17,11,2024",460.79,0.00,38892.14,
94,"17,11,2024","17,11,2024",0.00,367.00,39259.14,
95,"18,11,2024","18,11,2024",170.00,0.00,39089.14,
96,"17,11,2024","18,11,2024",0.00,6000.00,46589.14,
97,"17,11,2024","18,11,2024",0.00,1000.00,40589.14,
98,"17,11,2024","18,11,2024",0.00,500.00,39589.14,
99,"25,11,2024","25,11,2024",3363.44,0.00,43225.70,
100,"26,11,2024","26,11,2024",0.00,240.00,43465.70,
101,"29,11,2024","29,11,2024",0.00,2400.00,45865.70,
102,"29,11,2024","29,11,2024",0.00,80667.00,126532.70,
103,"30,11,2024","30,11,2024",38846.82,0.00,87685.88,
104,"02,12,2024","02,12,2024",1.00,0.00,87684.88,
105,"02,12,2024","02,12,2024",599.00,0.00,87085.88,
106,"02,12,2024","02,12,2024",19000.00,0.00,68085.88,
107,"05,12,2024","05,12,2024",236.00,0.00,67849.88,
108,"09,12,2024","09,12,2024",13383.29,0.00,54466.59,
109,"18,12,2024","18,12,2024",20434.00,0.00,34032.59,
110,"27,12,2024","27,12,2024",3355.86,0.00,30676.73,
111,"30,12,2024","31,12,2024",0.00,80667.00,111343.73,
112,"30,12,2024","31,12,2024",0.00,510.00,111853.73,
113,"01,01,2025","01,01,2025",38289.32,0.00,73564.41,
114,"01,01,2025","01,01,2025",0.00,509.86,74074.27,
115,"07,01,2025","07,01,2025",13352.65,0.00,60721.62,
116,"17,11,2024","08,01,2025",6000.00,0.00,53221.62,
117,"17,11,2024","08,01,2025",1000.00,0.00,59221.62,
118,"17,11,2024","08,01,2025",500.00,0.00,60221.62,
119,"17,01,2025","17,01,2025",17690.56,0.00,35531.06,
120,"29,01,2025","29,01,2025",3348.18,0.00,32182.88,
121,"30,01,2025","30,01,2025",0.00,80667.00,112849.88,
122,"31,01,2025","31,01,2025",34351.40,0.00,78498.48,
123,"05,02,2025","05,02,2025",13321.63,0.00,65176.85,
124,"06,02,2025","06,02,2025",2.00,0.00,65174.85,
125,"17,02,2025","17,02,2025",15132.64,0.00,50042.21,
126,"19,02,2025","19,02,2025",0.00,2000.00,52042.21,
127,"24,02,2025","24,02,2025",3340.38,0.00,48701.83,
128,"24,02,2025","24,02,2025",1.00,0.00,48700.83,
129,"28,02,2025","28,02,2025",0.00,80355.00,129055.83,
130,"28,02,2025","28,02,2025",0.00,1350.00,130405.83,
131,"28,02,2025","28,02,2025",4000.00,0.00,126405.83,
132,"03,03,2025","03,03,2025",0.00,420.00,126825.83,
133,"03,03,2025","03,03,2025",1.00,0.00,126824.83,
134,"03,03,2025","03,03,2025",19000.00,0.00,107824.83,
135,"03,03,2025","03,03,2025",838.00,0.00,106986.83,
136,"03,03,2025","03,03,2025",90.00,0.00,106896.83,
137,"04,03,2025","04,03,2025",316.00,0.00,106580.83,
138,"04,03,2025","04,03,2025",599.00,0.00,105981.83,
139,"04,03,2025","04,03,2025",280.00,0.00,105701.83,
140,"04,03,2025","04,03,2025",300.00,0.00,105401.83,
141,"05,03,2025","05,03,2025",500.00,0.00,104901.83,
142,"07,03,2025","07,03,2025",200.00,0.00,104701.83,
143,"07,03,2025","07,03,2025",1476.00,0.00,103225.83,
144,"07,03,2025","07,03,2025",500.00,0.00,102725.83,
145,"07,03,2025","07,03,2025",706.82,0.00,102019.01,
146,"08,03,2025","08,03,2025",500.00,0.00,101519.01,
147,"09,03,2025","09,03,2025",1.00,0.00,101518.01,
148,"09,03,2025","09,03,2025",300.80,0.00,101217.21,
149,"10,03,2025","10,03,2025",500.00,0.00,100717.21,
150,"10,03,2025","10,03,2025",500.00,0.00,100217.21,
151,"10,03,2025","10,03,2025",714.00,0.00,99503.21,
152,"10,03,2025","10,03,2025",953.00,0.00,98550.21,
153,"11,03,2025","11,03,2025",200.00,0.00,98350.21,
154,"11,03,2025","11,03,2025",85.00,0.00,98265.21,
155,"11,03,2025","11,03,2025",162.39,0.00,98102.82,
156,"12,03,2025","12,03,2025",94.52,0.00,98008.30,
157,"12,03,2025","12,03,2025",247.00,0.00,97761.30,
158,"12,03,2025","12,03,2025",145.00,0.00,97616.30,
159,"14,03,2025","14,03,2025",460.00,0.00,97156.30,
160,"16,03,2025","16,03,2025",100.00,0.00,97056.30,
161,"17,03,2025","17,03,2025",100.00,0.00,96956.30,
162,"17,03,2025","17,03,2025",16603.97,0.00,80352.33,
163,"17,03,2025","17,03,2025",712.00,0.00,79640.33,
164,"18,03,2025","18,03,2025",118.00,0.00,79522.33,
165,"18,03,2025","18,03,2025",100.00,0.00,79422.33,
166,"19,03,2025","19,03,2025",120.00,0.00,79302.33,
167,"19,03,2025","19,03,2025",108.00,0.00,79194.33,
168,"20,03,2025","20,03,2025",1000.00,0.00,78194.33,
169,"21,03,2025","21,03,2025",320.00,0.00,77874.33,
170,"21,03,2025","21,03,2025",180.00,0.00,77694.33,
171,"21,03,2025","21,03,2025",250.00,0.00,77444.33,
172,"22,03,2025","22,03,2025",235.00,0.00,77209.33,
,,,,,,
173,"23,03,2025","23,03,2025",420.00,0.00,76789.33,
174,"26,03,2025","26,03,2025",160.00,0.00,76629.33,
175,"26,03,2025","26,03,2025",1.00,0.00,76628.33,
176,"26,03,2025","26,03,2025",99.60,0.00,76528.73,
177,"27,03,2025","27,03,2025",528.00,0.00,76000.73,
178,"27,03,2025","27,03,2025",0.00,150.00,76150.73,
179,"27,03,2025","27,03,2025",41660.00,0.00,34490.73,
180,"27,03,2025","27,03,2025",0.00,480.00,34970.73,
181,"28,03,2025","29,03,2025",0.00,618.00,35588.73,
182,"29,03,2025","29,03,2025",0.00,80356.00,115944.73,
183,"29,03,2025","29,03,2025",100.00,0.00,115844.73,
184,"29,03,2025","29,03,2025",12870.00,0.00,102974.73,
185,"29,03,2025","29,03,2025",10000.00,0.00,92974.73,
186,"29,03,2025","29,03,2025",117.00,0.00,92857.73,
187,"29,03,2025","29,03,2025",500.00,0.00,92357.73,
188,"30,03,2025","30,03,2025",150.00,0.00,92207.73,
189,"31,03,2025","31,03,2025",200.00,0.00,92007.73,
190,"31,03,2025","31,03,2025",515.00,0.00,91492.73,
191,"01,04,2025","01,04,2025",108.00,0.00,91384.73,
192,"01,04,2025","01,04,2025",35.00,0.00,91349.73,
193,"01,04,2025","01,04,2025",26.00,0.00,91323.73,
194,"01,04,2025","01,04,2025",65.00,0.00,91258.73,
195,"01,04,2025","01,04,2025",104.00,0.00,91154.73,
196,"01,04,2025","01,04,2025",36.00,0.00,91118.73,
197,"02,04,2025","02,04,2025",141.11,0.00,90977.62,
,,,,,,
198,"02,04,2025","02,04,2025",35.00,0.00,90942.62,
199,"02,04,2025","02,04,2025",40.00,0.00,90902.62,
200,"02,04,2025","02,04,2025",13.00,0.00,90889.62,
201,"02,04,2025","02,04,2025",80.00,0.00,90809.62,
202,"02,04,2025","02,04,2025",105.00,0.00,90704.62,
203,"03,04,2025","03,04,2025",19000.00,0.00,71704.62,
204,"03,04,2025","03,04,2025",600.00,0.00,71104.62,
205,"04,04,2025","04,04,2025",599.00,0.00,70505.62,
206,"04,04,2025","04,04,2025",4000.00,0.00,66505.62,
207,"04,04,2025","04,04,2025",63.00,0.00,66442.62,
208,"04,04,2025","04,04,2025",1300.00,0.00,65142.62,
209,"04,04,2025","04,04,2025",100.00,0.00,65042.62,
210,"05,04,2025","05,04,2025",551.00,0.00,64491.62,
211,"05,04,2025","05,04,2025",0.00,52289.99,116781.61,
212,"05,04,2025","05,04,2025",150.00,0.00,116631.61,
213,"06,04,2025","06,04,2025",80.00,0.00,116551.61,
214,"06,04,2025","06,04,2025",180.00,0.00,116371.61,
215,"06,04,2025","06,04,2025",1017.00,0.00,115354.61,
216,"07,04,2025","07,04,2025",869.00,0.00,114485.61,
217,"07,04,2025","07,04,2025",50.00,0.00,114435.61,
218,"07,04,2025","07,04,2025",220.00,0.00,114215.61,
219,"07,04,2025","07,04,2025",25.00,0.00,114190.61,
220,"07,04,2025","07,04,2025",500.00,0.00,113690.61,
221,"07,04,2025","07,04,2025",0.00,5000.00,118690.61,
222,"07,04,2025","07,04,2025",5000.00,0.00,113690.61,
223,"07,04,2025","07,04,2025",0.00,5000.00,118690.61,
224,"08,04,2025","08,04,2025",5000.00,0.00,113690.61,
225,"08,04,2025","08,04,2025",146.00,0.00,113544.61,
226,"08,04,2025","08,04,2025",65.00,0.00,113479.61,
227,"08,04,2025","08,04,2025",35.00,0.00,113444.61,
228,"08,04,2025","08,04,2025",0.00,88000.00,201444.61,
229,"08,04,2025","08,04,2025",0.00,15000.00,216444.61,
230,"08,04,2025","08,04,2025",2.00,0.00,216442.61,
231,"08,04,2025","08,04,2025",199998.00,0.00,16444.61,
232,"08,04,2025","08,04,2025",140.00,0.00,16304.61,
233,"08,04,2025","08,04,2025",220.00,0.00,16084.61,
234,"08,04,2025","08,04,2025",160.00,0.00,15924.61,
235,"09,04,2025","09,04,2025",149.00,0.00,15775.61,
236,"09,04,2025","09,04,2025",65.00,0.00,15710.61,
237,"09,04,2025","09,04,2025",25.00,0.00,15685.61,
238,"09,04,2025","09,04,2025",147.00,0.00,15538.61,
239,"10,04,2025","10,04,2025",150.00,0.00,15388.61,
240,"10,04,2025","10,04,2025",119.00,0.00,15269.61,
241,"10,04,2025","10,04,2025",40.00,0.00,15229.61,
242,"10,04,2025","10,04,2025",180.00,0.00,15049.61,
243,"10,04,2025","10,04,2025",104.00,0.00,14945.61,
244,"11,04,2025","11,04,2025",328.00,0.00,14617.61,
,,,,,,
245,"12,04,2025","12,04,2025",3500.00,0.00,11117.61,
246,"12,04,2025","12,04,2025",25.00,0.00,11092.61,
247,"13,04,2025","13,04,2025",447.00,0.00,10645.61,
248,"15,04,2025","15,04,2025",1000.00,0.00,9645.61,
249,"15,04,2025","15,04,2025",2.00,0.00,9643.61,
250,"19,04,2025","19,04,2025",78.97,0.00,9564.64,
251,"19,04,2025","19,04,2025",2074.00,0.00,7490.64,
252,"19,04,2025","19,04,2025",150.00,0.00,7340.64,
253,"19,04,2025","19,04,2025",0.00,1.00,7341.64,
254,"19,04,2025","19,04,2025",312.00,0.00,7029.64,
255,"19,04,2025","19,04,2025",0.00,199999.00,207028.64,
256,"19,04,2025","19,04,2025",100.00,0.00,206928.64,
257,"19,04,2025","19,04,2025",159.00,0.00,206769.64,
258,"20,04,2025","20,04,2025",261.00,0.00,206508.64,
259,"20,04,2025","20,04,2025",80.00,0.00,206428.64,
260,"23,04,2025","23,04,2025",195.00,0.00,206233.64,
261,"23,04,2025","23,04,2025",50.00,0.00,206183.64,
262,"23,04,2025","23,04,2025",210.00,0.00,205973.64,
263,"24,04,2025","24,04,2025",1468.32,0.00,204505.32,
264,"24,04,2025","24,04,2025",270.00,0.00,204235.32,
265,"24,04,2025","24,04,2025",420.00,0.00,203815.32,
266,"26,04,2025","26,04,2025",500.00,0.00,203315.32,
267,"26,04,2025","26,04,2025",320.00,0.00,202995.32,
268,"27,04,2025","27,04,2025",3100.00,0.00,199895.32,
269,"27,04,2025","27,04,2025",0.00,500.00,200395.32,
270,"28,04,2025","28,04,2025",14499.00,0.00,185896.32,
271,"30,04,2025","01,05,2025",0.00,555977.00,741873.32,
272,"01,05,2025","01,05,2025",2000.00,0.00,739873.32,
273,"02,05,2025","02,05,2025",19000.00,0.00,720873.32,
274,"03,05,2025","03,05,2025",600.00,0.00,720273.32,
275,"03,05,2025","03,05,2025",50.00,0.00,720223.32,
276,"03,05,2025","03,05,2025",5.00,0.00,720218.32,
277,"04,05,2025","04,05,2025",599.00,0.00,719619.32,
278,"04,05,2025","04,05,2025",1696.00,0.00,717923.32,
279,"07,05,2025","07,05,2025",1477.00,0.00,716446.32,
280,"09,05,2025","09,05,2025",0.00,6988.00,723434.32,
281,"13,05,2025","13,05,2025",1025.40,0.00,722408.92,
282,"13,05,2025","13,05,2025",0.00,1025.00,723433.92,
283,"15,05,2025","15,05,2025",5000.00,0.00,718433.92,
284,"17,05,2025","17,05,2025",15764.20,0.00,702669.72,
285,"17,05,2025","17,05,2025",2159.00,0.00,700510.72,
286,"17,05,2025","17,05,2025",250.00,0.00,700260.72,
287,"17,05,2025","17,05,2025",267.00,0.00,699993.72,
288,"17,05,2025","17,05,2025",245.00,0.00,699748.72,
289,"17,05,2025","17,05,2025",858.00,0.00,698890.72,
290,"17,05,2025","17,05,2025",210.00,0.00,698680.72,
291,"17,05,2025","17,05,2025",569.00,0.00,698111.72,
292,"18,05,2025","18,05,2025",100.00,0.00,698011.72,
293,"20,05,2025","20,05,2025",59.60,0.00,697952.12,
294,"21,05,2025","21,05,2025",55.00,0.00,697897.12,
295,"21,05,2025","21,05,2025",80.00,0.00,697817.12,
296,"22,05,2025","22,05,2025",40.00,0.00,697777.12,
297,"22,05,2025","22,05,2025",110.00,0.00,697667.12,
298,"27,05,2025","27,05,2025",2.00,0.00,697665.12,
299,"30,05,2025","30,05,2025",393.00,0.00,697272.12,
300,"31,05,2025","31,05,2025",0.00,118955.00,816227.12,
301,"31,05,2025","31,05,2025",2000.00,0.00,814227.12,
302,"31,05,2025","31,05,2025",1500.00,0.00,812727.12,
303,"02,06,2025","02,06,2025",65.00,0.00,812662.12,
304,"02,06,2025","02,06,2025",0.00,65.00,812727.12,
305,"04,06,2025","04,06,2025",19900.00,0.00,792827.12,
306,"05,06,2025","05,06,2025",36500.00,0.00,756327.12,
307,"05,06,2025","05,06,2025",0.00,20000.00,776327.12,
308,"05,06,2025","05,06,2025",168.00,0.00,776159.12,
309,"05,06,2025","05,06,2025",320.00,0.00,775839.12,
310,"07,06,2025","07,06,2025",0.00,201962.99,977802.11,
311,"07,06,2025","07,06,2025",599.00,0.00,977203.11,
312,"07,06,2025","07,06,2025",150.00,0.00,977053.11,
313,"07,06,2025","07,06,2025",300.00,0.00,976753.11,
314,"08,06,2025","08,06,2025",239.00,0.00,976514.11,
315,"08,06,2025","08,06,2025",2109.00,0.00,974405.11,
316,"08,06,2025","08,06,2025",599.00,0.00,973806.11,
317,"08,06,2025","08,06,2025",50.00,0.00,973756.11,
318,"09,06,2025","09,06,2025",186.00,0.00,973570.11,
319,"09,06,2025","09,06,2025",35.00,0.00,973535.11,
320,"09,06,2025","09,06,2025",104.00,0.00,973431.11,
321,"11,06,2025","11,06,2025",593.00,0.00,972838.11,
322,"11,06,2025","11,06,2025",25.00,0.00,972813.11,
323,"12,06,2025","12,06,2025",221.00,0.00,972592.11,
324,"12,06,2025","12,06,2025",159.00,0.00,972433.11,
325,"12,06,2025","12,06,2025",350.00,0.00,972083.11,
326,"12,06,2025","12,06,2025",2000.00,0.00,970083.11,
327,"15,06,2025","15,06,2025",220.00,0.00,969863.11,
328,"16,06,2025","16,06,2025",160.00,0.00,969703.11,
329,"16,06,2025","16,06,2025",35.00,0.00,969668.11,
330,"16,06,2025","16,06,2025",90.00,0.00,969578.11,
331,"17,06,2025","17,06,2025",619.00,0.00,968959.11,
332,"17,06,2025","17,06,2025",11000.00,0.00,957959.11,
333,"18,06,2025","18,06,2025",435.00,0.00,957524.11,
334,"19,06,2025","19,06,2025",110.00,0.00,957414.11,
335,"20,06,2025","20,06,2025",20.00,0.00,957394.11,
336,"20,06,2025","20,06,2025",60.00,0.00,957334.11,
337,"21,06,2025","21,06,2025",10.00,0.00,957324.11,
338,"21,06,2025","21,06,2025",95000.00,0.00,862324.11,
339,"21,06,2025","21,06,2025",4000.00,0.00,858324.11,
340,"22,06,2025","22,06,2025",150.00,0.00,858174.11,
,,,,,,
341,"24,06,2025","24,06,2025",110.00,0.00,858064.11,
342,"24,06,2025","24,06,2025",125.00,0.00,857939.11,
343,"24,06,2025","24,06,2025",660.00,0.00,857279.11,
344,"25,06,2025","25,06,2025",2300.00,0.00,854979.11,
345,"28,06,2025","28,06,2025",0.00,118955.00,973934.11,
346,"29,06,2025","29,06,2025",8999.00,0.00,964935.11,
347,"29,06,2025","29,06,2025",98.00,0.00,964837.11,
348,"29,06,2025","30,06,2025",0.00,5369.00,970206.11,
349,"30,06,2025","30,06,2025",115.00,0.00,970091.11,
350,"30,06,2025","30,06,2025",120.00,0.00,969971.11,
351,"30,06,2025","30,06,2025",110.00,0.00,969861.11,
352,"01,07,2025","01,07,2025",4000.00,0.00,965861.11,
353,"01,07,2025","01,07,2025",1.00,0.00,965860.11,
354,"01,07,2025","01,07,2025",1.00,0.00,965859.11,
355,"02,07,2025","02,07,2025",190.00,0.00,965669.11,
356,"03,07,2025","03,07,2025",150.00,0.00,965519.11,
357,"03,07,2025","03,07,2025",600.00,0.00,964919.11,
358,"03,07,2025","03,07,2025",60.00,0.00,964859.11,
359,"03,07,2025","03,07,2025",19900.00,0.00,944959.11,
360,"03,07,2025","03,07,2025",599.00,0.00,944360.11,
361,"03,07,2025","03,07,2025",1000.00,0.00,943360.11,
362,"04,07,2025","04,07,2025",151.00,0.00,943209.11,
363,"05,07,2025","05,07,2025",120.00,0.00,943089.11,
364,"05,07,2025","05,07,2025",120.00,0.00,942969.11,
365,"05,07,2025","05,07,2025",10.00,0.00,942959.11,
366,"05,07,2025","05,07,2025",173.00,0.00,942786.11,
367,"05,07,2025","05,07,2025",2500.00,0.00,940286.11,
368,"05,07,2025","05,07,2025",145.00,0.00,940141.11,
369,"06,07,2025","06,07,2025",210.00,0.00,939931.11,
370,"06,07,2025","06,07,2025",110.00,0.00,939821.11,
371,"06,07,2025","06,07,2025",500.00,0.00,939321.11,
372,"07,07,2025","07,07,2025",145.00,0.00,939176.11,
373,"08,07,2025","08,07,2025",206.00,0.00,938970.11,
374,"08,07,2025","08,07,2025",115.00,0.00,938855.11,
375,"09,07,2025","09,07,2025",140.00,0.00,938715.11,
376,"09,07,2025","09,07,2025",115.00,0.00,938600.11,
377,"10,07,2025","10,07,2025",75.00,0.00,938525.11,
378,"10,07,2025","10,07,2025",18.00,0.00,938507.11,
379,"10,07,2025","10,07,2025",990.85,0.00,937516.26,
380,"10,07,2025","10,07,2025",300.80,0.00,937215.46,
381,"10,07,2025","10,07,2025",733.00,0.00,936482.46,
382,"11,07,2025","11,07,2025",0.00,200.00,936682.46,
383,"12,07,2025","12,07,2025",1500.00,0.00,935182.46,
384,"13,07,2025","13,07,2025",3000.00,0.00,932182.46,
385,"14,07,2025","14,07,2025",165.00,0.00,932017.46,
386,"14,07,2025","14,07,2025",70.00,0.00,931947.46,
387,"14,07,2025","14,07,2025",120.00,0.00,931827.46,
388,"15,07,2025","15,07,2025",902.00,0.00,930925.46,
389,"18,07,2025","18,07,2025",0.00,1.00,930926.46,
390,"18,07,2025","18,07,2025",0.00,1.00,930927.46,
391,"19,07,2025","19,07,2025",862.00,0.00,930065.46,
392,"19,07,2025","19,07,2025",3000.00,0.00,927065.46,
393,"20,07,2025","20,07,2025",100.00,0.00,926965.46,
394,"26,07,2025","26,07,2025",1808.00,0.00,925157.46,
395,"27,07,2025","27,07,2025",0.00,335.00,925492.46,
396,"28,07,2025","28,07,2025",100.00,0.00,925392.46,
397,"28,07,2025","28,07,2025",220000.00,0.00,705392.46,
398,"29,07,2025","29,07,2025",365.00,0.00,705027.46,
399,"30,07,2025","30,07,2025",2000.00,0.00,703027.46,
400,"30,07,2025","30,07,2025",100.00,0.00,702927.46,
401,"30,07,2025","30,07,2025",0.00,118955.00,821882.46,
402,"31,07,2025","31,07,2025",110.00,0.00,821772.46,
403,"31,07,2025","31,07,2025",1280.00,0.00,820492.46,
404,"01,08,2025","01,08,2025",226.00,0.00,820266.46,
,,,,,,
405,"01,08,2025","01,08,2025",2020.00,0.00,818246.46,
406,"01,08,2025","01,08,2025",7385.00,0.00,810861.46,
407,"01,08,2025","01,08,2025",300.00,0.00,810561.46,
408,"01,08,2025","01,08,2025",4000.00,0.00,806561.46,
409,"01,08,2025","01,08,2025",100.00,0.00,806461.46,
410,"01,08,2025","01,08,2025",200.00,0.00,806261.46,
411,"02,08,2025","02,08,2025",170.00,0.00,806091.46,
412,"02,08,2025","02,08,2025",310.00,0.00,805781.46,
413,"02,08,2025","02,08,2025",20.00,0.00,805761.46,
414,"02,08,2025","02,08,2025",599.00,0.00,805162.46,
415,"02,08,2025","02,08,2025",1000.00,0.00,804162.46,
416,"03,08,2025","03,08,2025",266.00,0.00,803896.46,
417,"04,08,2025","04,08,2025",40.00,0.00,803856.46,
418,"04,08,2025","04,08,2025",130.00,0.00,803726.46,
419,"04,08,2025","04,08,2025",36.75,0.00,803689.71,
420,"04,08,2025","04,08,2025",500.00,0.00,803189.71,
421,"05,08,2025","05,08,2025",130.00,0.00,803059.71,
422,"05,08,2025","05,08,2025",94.00,0.00,802965.71,
423,"05,08,2025","05,08,2025",60.00,0.00,802905.71,
424,"05,08,2025","05,08,2025",108.00,0.00,802797.71,
425,"05,08,2025","05,08,2025",35.00,0.00,802762.71,
426,"05,08,2025","05,08,2025",20000.00,0.00,782762.71,
427,"06,08,2025","06,08,2025",0.00,94.00,782856.71,
428,"06,08,2025","06,08,2025",120.00,0.00,782736.71,
429,"06,08,2025","06,08,2025",60.00,0.00,782676.71,
430,"06,08,2025","06,08,2025",130.00,0.00,782546.71,
431,"06,08,2025","06,08,2025",124.61,0.00,782422.10,
432,"07,08,2025","07,08,2025",120.00,0.00,782302.10,
433,"07,08,2025","07,08,2025",60.00,0.00,782242.10,
434,"07,08,2025","07,08,2025",130.00,0.00,782112.10,
435,"07,08,2025","07,08,2025",130.00,0.00,781982.10,
436,"08,08,2025","08,08,2025",0.00,130.00,782112.10,
437,"08,08,2025","08,08,2025",90.00,0.00,782022.10,
438,"09,08,2025","09,08,2025",80.00,0.00,781942.10,
439,"09,08,2025","09,08,2025",350.00,0.00,781592.10,
440,"09,08,2025","09,08,2025",5.00,0.00,781587.10,
441,"10,08,2025","10,08,2025",80.00,0.00,781507.10,
442,"10,08,2025","10,08,2025",8.00,0.00,781499.10,
443,"11,08,2025","11,08,2025",96.00,0.00,781403.10,
444,"11,08,2025","11,08,2025",45.00,0.00,781358.10,
445,"11,08,2025","11,08,2025",119.00,0.00,781239.10,
446,"11,08,2025","11,08,2025",119.00,0.00,781120.10,
447,"11,08,2025","11,08,2025",118.00,0.00,781002.10,
448,"11,08,2025","11,08,2025",40.00,0.00,780962.10,
449,"11,08,2025","11,08,2025",0.00,15000.00,795962.10,
450,"11,08,2025","11,08,2025",0.00,1.00,795963.10,
451,"11,08,2025","11,08,2025",0.00,13000.00,808963.10,
452,"12,08,2025","12,08,2025",0.00,119.00,809082.10,
453,"12,08,2025","12,08,2025",121.25,0.00,808960.85,
454,"12,08,2025","12,08,2025",40.00,0.00,808920.85,
455,"12,08,2025","12,08,2025",60.00,0.00,808860.85,
456,"12,08,2025","12,08,2025",0.00,40.00,808900.85,
457,"12,08,2025","12,08,2025",95.00,0.00,808805.85,
458,"12,08,2025","12,08,2025",136.00,0.00,808669.85,
459,"14,08,2025","14,08,2025",80.00,0.00,808589.85,
460,"15,08,2025","15,08,2025",80.00,0.00,808509.85,
461,"15,08,2025","15,08,2025",220.00,0.00,808289.85,
462,"16,08,2025","16,08,2025",273.00,0.00,808016.85,
463,"16,08,2025","16,08,2025",90.00,0.00,807926.85,
464,"17,08,2025","17,08,2025",551.00,0.00,807375.85,
465,"18,08,2025","18,08,2025",148.00,0.00,807227.85,
466,"18,08,2025","18,08,2025",60.00,0.00,807167.85,
467,"18,08,2025","18,08,2025",130.00,0.00,807037.85,
468,"18,08,2025","18,08,2025",111.00,0.00,806926.85,
469,"19,08,2025","19,08,2025",56.00,0.00,806870.85,
470,"19,08,2025","19,08,2025",142.00,0.00,806728.85,
471,"19,08,2025","19,08,2025",75.00,0.00,806653.85,
472,"19,08,2025","19,08,2025",0.00,66.00,806719.85,
473,"19,08,2025","19,08,2025",99.00,0.00,806620.85,
474,"19,08,2025","19,08,2025",30.00,0.00,806590.85,
475,"19,08,2025","19,08,2025",127.00,0.00,806463.85,
476,"19,08,2025","19,08,2025",120.00,0.00,806343.85,
477,"20,08,2025","20,08,2025",110.00,0.00,806233.85,
478,"20,08,2025","20,08,2025",130.00,0.00,806103.85,
479,"21,08,2025","21,08,2025",273.00,0.00,805830.85,
480,"21,08,2025","21,08,2025",105.00,0.00,805725.85,
481,"21,08,2025","21,08,2025",60.00,0.00,805665.85,
482,"21,08,2025","21,08,2025",2000.00,0.00,803665.85,
483,"21,08,2025","21,08,2025",119.00,0.00,803546.85,
484,"21,08,2025","21,08,2025",110.00,0.00,803436.85,
485,"22,08,2025","22,08,2025",150.00,0.00,803286.85,
486,"22,08,2025","22,08,2025",122.00,0.00,803164.85,
487,"22,08,2025","22,08,2025",200.00,0.00,802964.85,
488,"23,08,2025","23,08,2025",80.00,0.00,802884.85,
489,"23,08,2025","23,08,2025",40.00,0.00,802844.85,
490,"23,08,2025","23,08,2025",220.00,0.00,802624.85,
491,"23,08,2025","23,08,2025",110.00,0.00,802514.85,
492,"24,08,2025","24,08,2025",80.00,0.00,802434.85,
493,"25,08,2025","25,08,2025",100.55,0.00,802334.30,
494,"25,08,2025","25,08,2025",75.00,0.00,802259.30,
495,"25,08,2025","25,08,2025",119.00,0.00,802140.30,
496,"26,08,2025","26,08,2025",107.30,0.00,802033.00,
497,"26,08,2025","26,08,2025",45.00,0.00,801988.00,
498,"26,08,2025","26,08,2025",94.75,0.00,801893.25,
499,"26,08,2025","26,08,2025",221.00,0.00,801672.25,
500,"26,08,2025","26,08,2025",0.00,10.00,801682.25,
501,"26,08,2025","26,08,2025",11.00,0.00,801671.25,
502,"26,08,2025","26,08,2025",334.96,0.00,801336.29,
503,"28,08,2025","28,08,2025",130.00,0.00,801206.29,
504,"28,08,2025","28,08,2025",65.00,0.00,801141.29,
505,"28,08,2025","28,08,2025",95.00,0.00,801046.29,
506,"29,08,2025","29,08,2025",96.00,0.00,800950.29,
507,"29,08,2025","29,08,2025",65.00,0.00,800885.29,
508,"29,08,2025","29,08,2025",110.00,0.00,800775.29,
,,,,,,
509,"29,08,2025","29,08,2025",70.00,0.00,800705.29,
510,"30,08,2025","30,08,2025",0.00,118955.00,919660.29,
511,"30,08,2025","30,08,2025",92.00,0.00,919568.29,
512,"30,08,2025","30,08,2025",60.00,0.00,919508.29,
513,"30,08,2025","30,08,2025",119.00,0.00,919389.29,
514,"30,08,2025","30,08,2025",109.00,0.00,919280.29,
515,"30,08,2025","30,08,2025",5900.00,0.00,913380.29,
516,"31,08,2025","31,08,2025",80.00,0.00,913300.29,
517,"31,08,2025","31,08,2025",2034.00,0.00,911266.29,
518,"31,08,2025","31,08,2025",100.00,0.00,911166.29,
519,"01,09,2025","01,09,2025",108.00,0.00,911058.29,
520,"01,09,2025","01,09,2025",60.00,0.00,910998.29,
521,"01,09,2025","01,09,2025",2000.00,0.00,908998.29,
522,"01,09,2025","01,09,2025",130.00,0.00,908868.29,
523,"01,09,2025","01,09,2025",124.00,0.00,908744.29,
524,"02,09,2025","02,09,2025",100.00,0.00,908644.29,
525,"02,09,2025","02,09,2025",40.00,0.00,908604.29,
526,"02,09,2025","02,09,2025",119.00,0.00,908485.29,
527,"02,09,2025","02,09,2025",90.00,0.00,908395.29,
528,"02,09,2025","02,09,2025",35.00,0.00,908360.29,
529,"02,09,2025","02,09,2025",80.00,0.00,908280.29,
,,,,,,
530,"03,09,2025","03,09,2025",40.00,0.00,908240.29,
531,"03,09,2025","03,09,2025",110.00,0.00,908130.29,
532,"03,09,2025","03,09,2025",100.00,0.00,908030.29,
533,"03,09,2025","03,09,2025",100.00,0.00,907930.29,
534,"03,09,2025","03,09,2025",600.00,0.00,907330.29,
535,"04,09,2025","04,09,2025",0.00,100.00,907430.29,
536,"04,09,2025","04,09,2025",80.00,0.00,907350.29,
537,"05,09,2025","05,09,2025",80.00,0.00,907270.29,
538,"05,09,2025","05,09,2025",518.00,0.00,906752.29,
539,"05,09,2025","05,09,2025",7920.00,0.00,898832.29,
540,"06,09,2025","06,09,2025",100.00,0.00,898732.29,
541,"06,09,2025","06,09,2025",40.00,0.00,898692.29,
542,"06,09,2025","06,09,2025",35.00,0.00,898657.29,
543,"06,09,2025","06,09,2025",110.00,0.00,898547.29,
544,"06,09,2025","06,09,2025",599.00,0.00,897948.29,
545,"06,09,2025","06,09,2025",110.00,0.00,897838.29,
546,"07,09,2025","07,09,2025",480.00,0.00,897358.29,
547,"07,09,2025","07,09,2025",205.00,0.00,897153.29,
548,"07,09,2025","07,09,2025",2002.00,0.00,895151.29,
549,"07,09,2025","07,09,2025",190.00,0.00,894961.29,
550,"07,09,2025","07,09,2025",10.00,0.00,894951.29,
,,,,,,
551,"07,09,2025","07,09,2025",125.00,0.00,894826.29,
552,"07,09,2025","07,09,2025",121.00,0.00,894705.29,
553,"07,09,2025","07,09,2025",110.00,0.00,894595.29,
554,"08,09,2025","08,09,2025",599.00,0.00,893996.29,
555,"08,09,2025","08,09,2025",20.00,0.00,893976.29,
556,"08,09,2025","08,09,2025",370.00,0.00,893606.29,
557,"08,09,2025","08,09,2025",70.00,0.00,893536.29,
558,"08,09,2025","08,09,2025",1500.00,0.00,892036.29,
559,"08,09,2025","08,09,2025",250.00,0.00,891786.29,
560,"08,09,2025","08,09,2025",840.00,0.00,890946.29,
561,"08,09,2025","08,09,2025",918.00,0.00,890028.29,
562,"08,09,2025","08,09,2025",780.00,0.00,889248.29,
563,"09,09,2025","09,09,2025",105.00,0.00,889143.29,
564,"09,09,2025","09,09,2025",40.00,0.00,889103.29,
565,"09,09,2025","09,09,2025",35.00,0.00,889068.29,
566,"09,09,2025","09,09,2025",123.00,0.00,888945.29,
567,"09,09,2025","09,09,2025",24.00,0.00,888921.29,
568,"10,09,2025","10,09,2025",60.00,0.00,888861.29,
569,"10,09,2025","10,09,2025",1500.00,0.00,887361.29,
570,"10,09,2025","10,09,2025",500.00,0.00,886861.29,
571,"10,09,2025","10,09,2025",1000.00,0.00,885861.29,
,,,,,,
572,"10,09,2025","10,09,2025",500.00,0.00,885361.29,
573,"11,09,2025","11,09,2025",0.00,200.00,885561.29,
574,"11,09,2025","11,09,2025",135.00,0.00,885426.29,
575,"11,09,2025","11,09,2025",40.00,0.00,885386.29,
576,"11,09,2025","11,09,2025",40.00,0.00,885346.29,
577,"11,09,2025","11,09,2025",130.00,0.00,885216.29,
578,"11,09,2025","11,09,2025",200.00,0.00,885016.29,
579,"12,09,2025","12,09,2025",120.00,0.00,884896.29,
580,"12,09,2025","12,09,2025",1592.00,0.00,883304.29,
581,"12,09,2025","12,09,2025",108.00,0.00,883196.29,
582,"13,09,2025","13,09,2025",90.00,0.00,883106.29,
583,"13,09,2025","13,09,2025",260.00,0.00,882846.29,
584,"13,09,2025","13,09,2025",2739.00,0.00,880107.29,
585,"13,09,2025","13,09,2025",292.00,0.00,879815.29,
586,"14,09,2025","14,09,2025",12135.00,0.00,867680.29,
587,"14,09,2025","14,09,2025",2300.00,0.00,865380.29,
588,"14,09,2025","14,09,2025",23684.00,0.00,841696.29,
589,"14,09,2025","14,09,2025",480.00,0.00,841216.29,
590,"14,09,2025","14,09,2025",410.00,0.00,840806.29,
591,"14,09,2025","14,09,2025",6720.00,0.00,834086.29,
592,"14,09,2025","14,09,2025",1315.00,0.00,832771.29,
593,"15,09,2025","15,09,2025",105.00,0.00,832666.29,
594,"15,09,2025","15,09,2025",81.00,0.00,832585.29,
595,"16,09,2025","16,09,2025",120.00,0.00,832465.29,
596,"16,09,2025","16,09,2025",10000.00,0.00,822465.29,
597,"16,09,2025","16,09,2025",1500.00,0.00,820965.29,
598,"16,09,2025","16,09,2025",250.00,0.00,820715.29,
599,"16,09,2025","16,09,2025",72.00,0.00,820643.29,
600,"16,09,2025","16,09,2025",150.00,0.00,820493.29,
601,"17,09,2025","17,09,2025",3883.00,0.00,816610.29,
602,"17,09,2025","17,09,2025",140.00,0.00,816470.29,
603,"17,09,2025","17,09,2025",150.00,0.00,816320.29,
604,"17,09,2025","17,09,2025",40000.00,0.00,776320.29,
605,"17,09,2025","17,09,2025",15000.00,0.00,761320.29,
606,"17,09,2025","17,09,2025",20.00,0.00,761300.29,
607,"17,09,2025","17,09,2025",210.00,0.00,761090.29,
608,"18,09,2025","18,09,2025",3115.00,0.00,757975.29,
609,"18,09,2025","18,09,2025",488.00,0.00,757487.29,
610,"18,09,2025","18,09,2025",328.00,0.00,757159.29,
611,"18,09,2025","18,09,2025",0.00,96155.00,853314.29,
612,"18,09,2025","18,09,2025",310.00,0.00,853004.29,
613,"19,09,2025","19,09,2025",2549.10,0.00,850455.19,
,,,,,,
614,"19,09,2025","19,09,2025",4951.00,0.00,845504.19,
615,"19,09,2025","19,09,2025",328.39,0.00,845175.80,
616,"20,09,2025","20,09,2025",767.00,0.00,844408.80,
617,"20,09,2025","20,09,2025",273.00,0.00,844135.80,
618,"20,09,2025","20,09,2025",489.00,0.00,843646.80,
619,"20,09,2025","20,09,2025",312.54,0.00,843334.26,
620,"21,09,2025","21,09,2025",0.00,7500.00,850834.26,
621,"21,09,2025","21,09,2025",24000.00,0.00,826834.26,
622,"21,09,2025","21,09,2025",3000.00,0.00,823834.26,
623,"21,09,2025","21,09,2025",50000.00,0.00,773834.26,
624,"22,09,2025","22,09,2025",72.00,0.00,773762.26,
625,"22,09,2025","22,09,2025",100.00,0.00,773662.26,
626,"22,09,2025","22,09,2025",70.00,0.00,773592.26,
627,"22,09,2025","22,09,2025",517.00,0.00,773075.26,
628,"22,09,2025","22,09,2025",266.34,0.00,772808.92,
629,"23,09,2025","23,09,2025",72.00,0.00,772736.92,
630,"23,09,2025","23,09,2025",405.00,0.00,772331.92,
631,"23,09,2025","23,09,2025",110.00,0.00,772221.92,
632,"23,09,2025","23,09,2025",70.00,0.00,772151.92,
633,"23,09,2025","23,09,2025",265.29,0.00,771886.63,
634,"24,09,2025","24,09,2025",0.00,1330.00,773216.63,
,,,,,,
635,"24,09,2025","24,09,2025",1.00,0.00,773215.63,
636,"24,09,2025","24,09,2025",261.50,0.00,772954.13,
637,"24,09,2025","24,09,2025",382.25,0.00,772571.88,
638,"25,09,2025","25,09,2025",60.00,0.00,772511.88,
639,"27,09,2025","27,09,2025",381.15,0.00,772130.73,
640,"28,09,2025","28,09,2025",80.00,0.00,772050.73,
641,"28,09,2025","28,09,2025",120.00,0.00,771930.73,
642,"29,09,2025","29,09,2025",70.00,0.00,771860.73,
643,"29,09,2025","29,09,2025",110.00,0.00,771750.73,
644,"29,09,2025","29,09,2025",50.00,0.00,771700.73,
645,"29,09,2025","29,09,2025",76.00,0.00,771624.73,
646,"29,09,2025","29,09,2025",290.00,0.00,771334.73,
647,"29,09,2025","30,09,2025",0.00,7331.00,778665.73,
648,"30,09,2025","30,09,2025",0.00,223240.00,1001905.73,
649,"30,09,2025","30,09,2025",70.00,0.00,1001835.73,
650,"30,09,2025","30,09,2025",80.00,0.00,1001755.73,
651,"30,09,2025","30,09,2025",1.00,0.00,1001754.73,
652,"30,09,2025","30,09,2025",65.22,0.00,1001689.51,
653,"01,10,2025","01,10,2025",25156.00,0.00,976533.51,
654,"01,10,2025","01,10,2025",340.00,0.00,976193.51,
655,"02,10,2025","02,10,2025",220.00,0.00,975973.51,
656,"03,10,2025","03,10,2025",599.00,0.00,975374.51,
657,"03,10,2025","03,10,2025",600.00,0.00,974774.51,
658,"03,10,2025","03,10,2025",0.00,7800.00,982574.51,
659,"03,10,2025","03,10,2025",352.00,0.00,982222.51,
660,"04,10,2025","04,10,2025",522.50,0.00,981700.01,
661,"04,10,2025","04,10,2025",230.00,0.00,981470.01,
662,"05,10,2025","05,10,2025",784.11,0.00,980685.90,
663,"05,10,2025","05,10,2025",190.00,0.00,980495.90,
664,"05,10,2025","05,10,2025",1000.00,0.00,979495.90,
665,"06,10,2025","06,10,2025",121.00,0.00,979374.90,
666,"06,10,2025","06,10,2025",90.00,0.00,979284.90,
667,"06,10,2025","06,10,2025",80.00,0.00,979204.90,
668,"06,10,2025","06,10,2025",90.00,0.00,979114.90,
669,"06,10,2025","06,10,2025",145.00,0.00,978969.90,
670,"07,10,2025","07,10,2025",110.00,0.00,978859.90,
671,"07,10,2025","07,10,2025",75.00,0.00,978784.90,
672,"07,10,2025","07,10,2025",60.00,0.00,978724.90,
673,"07,10,2025","07,10,2025",45.00,0.00,978679.90,
674,"07,10,2025","07,10,2025",131.00,0.00,978548.90,
675,"08,10,2025","08,10,2025",110.00,0.00,978438.90,
676,"08,10,2025","08,10,2025",90.00,0.00,978348.90,
677,"08,10,2025","08,10,2025",93.00,0.00,978255.90,
,,,,,,
678,"08,10,2025","08,10,2025",0.00,50000.00,1028255.90,
679,"08,10,2025","08,10,2025",100.00,0.00,1028155.90,
680,"08,10,2025","08,10,2025",132.00,0.00,1028023.90,
681,"09,10,2025","09,10,2025",114.00,0.00,1027909.90,
682,"09,10,2025","09,10,2025",93.00,0.00,1027816.90,
683,"09,10,2025","09,10,2025",90.00,0.00,1027726.90,
684,"10,10,2025","10,10,2025",715.40,0.00,1027011.50,
685,"10,10,2025","10,10,2025",120.00,0.00,1026891.50,
686,"10,10,2025","10,10,2025",70.00,0.00,1026821.50,
687,"10,10,2025","10,10,2025",750.00,0.00,1026071.50,
688,"11,10,2025","11,10,2025",2191.48,0.00,1023880.02,
689,"11,10,2025","11,10,2025",3973.00,0.00,1019907.02,
690,"11,10,2025","11,10,2025",470.00,0.00,1019437.02,
691,"12,10,2025","12,10,2025",1500.00,0.00,1017937.02,
692,"12,10,2025","12,10,2025",6501.00,0.00,1011436.02,
693,"12,10,2025","12,10,2025",335.00,0.00,1011101.02,
694,"13,10,2025","13,10,2025",430.00,0.00,1010671.02,
695,"13,10,2025","13,10,2025",100.00,0.00,1010571.02,
696,"13,10,2025","13,10,2025",860.00,0.00,1009711.02,
697,"13,10,2025","13,10,2025",130.00,0.00,1009581.02,
698,"14,10,2025","14,10,2025",100.00,0.00,1009481.02,
699,"14,10,2025","14,10,2025",0.00,2969.00,1012450.02,
700,"14,10,2025","14,10,2025",62.00,0.00,1012388.02,
701,"14,10,2025","14,10,2025",100.00,0.00,1012288.02,
702,"14,10,2025","14,10,2025",26.00,0.00,1012262.02,
703,"15,10,2025","15,10,2025",100.00,0.00,1012162.02,
704,"15,10,2025","15,10,2025",0.00,100.00,1012262.02,
705,"15,10,2025","15,10,2025",95.00,0.00,1012167.02,
706,"15,10,2025","15,10,2025",7544.00,0.00,1004623.02,
707,"15,10,2025","15,10,2025",61.00,0.00,1004562.02,
708,"15,10,2025","15,10,2025",69.00,0.00,1004493.02,
709,"15,10,2025","15,10,2025",100.00,0.00,1004393.02,
710,"16,10,2025","16,10,2025",431.15,0.00,1003961.87,
711,"16,10,2025","16,10,2025",355.00,0.00,1003606.87,
712,"16,10,2025","16,10,2025",70.00,0.00,1003536.87,
713,"16,10,2025","16,10,2025",6800.00,0.00,996736.87,
714,"16,10,2025","16,10,2025",700.00,0.00,996036.87,
Legends Used in Account Statement,,,,,,
1. INFT - Internal Fund Transfer (Within ICICI Bank),,,,,,
2. BPAY - Bill payment,,,,,,
3. BBPS - Bharat Bill Payment Service,,,,,,
4. NEFT - National Electronics Funds Transfer System (Other Bank Fund transfer),,,,,,
5. RCHG - Recharge,,,,,,
6. ONL - Online Shopping transaction (Payment done on third party website),,,,,,
7. SMO - Smart Money order,,,,,,
8. DTAX - Direct Tax,,,,,,
9. IDTX - Indirect Tax,,,,,,
10. PAVC - Pay any Visa credit card,,,,,,
11. PAC - Personal Accident cover,,,,,,
12. LNPY - Linked loan payment,,,,,,
13. CCWD - Cardless Cash Withdrawal,,,,,,
14. PAYC - Pay to Contact,,,,,,
15. IMPS - Immediate Payment Service,,,,,,
16. VAT / MAT / NFS - Cash withdrawal at other bank ATM,,,,,,
17. INF - Internet fund transfer in linked accounts,,,,,,
18. EBA - Transaction on ICICI Direct,,,,,,
19. BIL - Internet Bill payment or funds transfer to Third party,,,,,,
20. VPS / IPS - Debit card transaction,,,,,,
21. TOP - Mobile recharge,,,,,,
22. BCTT - Banking Cash Transaction Tax,,,,,,
23. UCCBRN CMS - Upcountry cheque collection,,,,,,
24. LCCBRN CMS - Local cheque collection,,,,,,
25. N chg - NEFT Charges,,,,,,
26. MMT - Mobile Money Transfer (Insta FT - IMPS),,,,,,
27. T Chg - Travel Charges,,,,,,
